C 225,30,0
NO ./textures/white_64.png
SO ./textures/white_64.png
EA ./textures/desktop.png
F 220,100,0
WE ./textures/white_64.png
1111111111111111111111111
1000000000110000000000001
1011000001110000000000001
100100000000000000000000111111111
111111111011000001110000000000001
1000000000110  001110111101111111
11110111111111011100000010001
11110111111111011101010010001
11000000110101011100000010001
10000000000000001100000010001
10000000000000001101010010001
11000001110101011111011110N0111
11110111 1111101 101111010001
11111111 1111111 111111111111    