
             
    
    NO ./textures/test/desktop.png


        EA ./textures/test/white_64.png
SO ./textures/test/white_64.png         


        F 0,0,0         
C 255,255,255           
WE ./textures/test/white_64.png
    1111111111111111111111111
    1000000000110000000000001   
    1011000001110000000000001    
    110010000000000000000000011111111
    1111111111011000001110000000000001
    1000000000110  001110111101111111    
   111101111111110111000000100011
    111101111  111011101010010001
    11000000111101011100000010001
    11100000000000000011000000101  
    100000S0000000001101010010001  
    1100000111010101111101111000111 
    11110111 1111101 101111010001
    11111111 1111111 111111111111   
