EA textures/colors/128x128-00ff00ff.png
NO textures/colors/128x128-0000ffff.png
WE textures/colors/128x128-808080ff.png
SO textures/colors/128x128-ff0000ff.png
D textures/512x512/Brick_13.png

F 30,30,50
C 180,180,255
11111111111111111111111111111111111111111
10100010000000000001000001000000000000001
10101011111011111010111111111011101111111
10001010000010000000100000000010000000101
11101110111110111011111011101110101111101
10100010101000001000001000101000100010001
10101111101011111010111110101011101011101
10100010100000001010001010101000101000001
10111010101110101111101010101010111010101
100000001000101010D0000N00D01010100010101
10101110101110111010111010111010111110101
10100010000010001000101010000010100000101
10111011111111101010101111101111111011101
10001010101000001010100000101000100000101
10111110101111101110111011111011111111101
10000010001000000010000000100010001010001
11101010111111101110111111101110101010111
10001000001000100010101010000000101010001
11111010111010111111101011101111101011101
10000010001010101010100010000010100010001
11101011101110101010101110111110111111101
10101000101000001010000000001000100010001
10101011101011101010111011111110111010111
10001010000000100010001010100000001010001
11111111101111111010101110101011101010101
10100000001000000010100010101000101010101
11111010101111111110111110111110111010111
10000010101000000000100010001010000000001
11111110101110111010101110111010101111101
10100010101000100010100010000000101010001
10111010101011111110111011101111101011111
10001010101010000010000010000010000000001
11101011101110111111101010101111111011111
10000010100010001000001000101010000000101
10111110101111101111101111101011101110101
10001000101010100000101000000010000010101
11101010111010101110101011111111111011101
10101010100010001000101000100000000000001
10101010101011101011101011101110111010101
100000100010000010000010100010000010101D1
11111111111111111111111111111111111111111
