EA textures/maze/concrete.png
NO textures/maze/overgrown.png
WE textures/maze/concrete.png
SO textures/maze/vine_leaves.png
D textures/maze/gate.png
F 60,70,60
C 180,210,240

                1111111
             111       111
           11 1 111 1 1 1111
         11     1 1 1     1 11
        1111111 1 1 11111 1 1 1
      111   1 1 1   1 1   1 1  11
     111111 1 1 11111 1 111 111111
     1  1 1     1 1 1     1      1
    111 1 1 1 1 1 1 111 11111 11111
   1  1     1 1 1   1 1       1    1
   11 11111 11111 111 1 1 1 1 1 1111
  1   1 1     1     1 1 1 1 1 1 1   1
  111 1 1 11111 11111 1 1 1111111 111
 1  1   1 1   1     1 1 1   1 1 1 1  1
 1111 1 1 1 1111111D111111111 1 1111 1
 1  1 1 1   1 1         1 1          1
111 111 1111111         11111 111 1 111
1       1     1         1       1 1 111
1111111 1 1 1 1         111 1111111 111
1       1 1 1 D    N    D     1     1 1
11111 1 111 111         11111 1 111 1 1
1 1 1 1 1 1 1 1         1         1   1
1 1 1 111 1 1 1         1 1 1 111 1 111
 11       1 1 1         1 1 1 1 1 1  1
 1111 111 1 1 11111D111111111 1 1 1  1
 1  1 1 1     1 1     1     1 1   1  1
  1 1 1 111 111 11111 1 111 1 1 1 1 1
  1     1     1 1         1 1 1 1 111
   11 11111 1 1 111 11111111111 1 11
   11     1 1 1 1   1 1     1 1    1
    1111111 111 1 1 1 111 111 11111
     11 1 1     1 1 1            1
     11 1 1 1 111 11111 111 111  1
      11    1 1 1     1 1 1   111
        1 111 1 111 111 1 11111
         11 1     1   1     11
           11 11 1111 1 1 11
             111       111
                1111111
