
NO textures/colors/blue.png
WE textures/colors/magenta.png
SO textures/colors/aqua.png
EA textures/colors/yellow.png

D textures/colors/gray.png

F 126,200,80
C 35,56,63

111111111111111111111
1      D     D      1
1      1     1      1
1      1     1      1
1       1   1       1
1        1 1        1
1       11D11       1
1      11   11      1
1      D     D      1
1      1     1      1
1     1   1   1     1
1    11       11    1
1    1         1    1
1    1   1 1   1    1
1    D    N    D    1
1    1   1 1   1    1
1    1         1    1
1    11       11    1
1     1   1   1     1
1      1     1      1
1      D     D      1
1      11   11      1
1       11D11       1
1        1 1        1
1       1   1       1
1      1     1      1
1      1     1      1
1      D     D      1
111111111111111111111
