
EA textures/colors/64x64-008080ff.png
NO textures/colors/64x64-800080ff.png
WE textures/colors/64x64-808000ff.png
SO textures/colors/64x64-808080ff.png

F 124, 252, 0
C 135, 206, 235


111111111
1       1
1       1
1       1
1   N   1
1       1
1       1
1       1
111111111
