NO ./textures/test/north_64.png
SO ./textures/test/south_64.png
WE ./textures/test/white_64.png
EA ./textures/test/east_64.png
D ./textures/test/white_64.png
C 120,180,250
F 20,142,255
      111111111111111111
       10000000000000001
111111110000000000000001
100000010111111111111001
10000000000000001   1001
100000D0000000001   1001
10000000000000001   1111
10001111110000001
10001    100000011111111111111111111
100011111100000000000000000000000001
10N0D0000000000010000111111111111111
1111111111111111100001
                100001
                100001
                111111