NO ./textures/test/north_64.png
SO ./textures/test/south_64.png
WE ./textures/test/white_64.png
EA ./textures/test/east_64.png
F 30,30,50
0 180,180,255
111111111111111111111
101000000000001000001
100011111111101010101
101110000000101010101
101011110110001011101
101000000111011000001
101011111101011110111
100010100000001000001
101010111101101010101
101000101000101110101
101010101010100000101
111110101000111111111
1S1010001111101000001
101011100000001011111
101010111111101010101
101010001000101010101
101010100010100000001
100000111110111101111
111110101100010101111
100000000111000000001
111111111111111111111
