NO ./textures/test/north_64.png
SO ./textures/test/south_64.png
WE ./textures/test/white_64.png
EA ./textures/test/east_64.png
F 30,30,50
C 180,180,255
      111111111111111111
       10000000000000001
111111110000000000000001
10000001D111111111111001
10000000000000001   1001
10000000000000001   1001
10000000000000001   1111
10001111110000001
10001    100000011111111111111111111
1000111111000000D0000000000000000001
10N000000D00000010000111111111111111
1111111111111111100001
                100001
                100001
                111111