NO ./textures/test/north_64.png
SO ./textures/test/south_64.png
WE ./textures/test/white_64.png
EA ./textures/test/east_64.png
F 30,30,30
C 128,128,128
 111111111
 100000001
 10DDDDD01
 10D000D01
 10D0N0D01
 10D000D01
 10DDDDD01
 100000001
 111111111
